F 58,47,11
C 0,0,0

NO ./textures/Catacomb_Grates.png
SO ./textures/Catacomb_Wall.png
WE ./textures/Catacomb_Sand.png
EA ./textures/Catacomb_Window.png

1111111111111111111
1001001001001001001
1001001001001001001
1001001001001001001
1001001000001001001

1000000000N00000001
1000011111111000001
1111000000000001111
1000000101010000001
1111111111111111111

